34,17,17,17,17,17,17,17,24,24,17,17,17,17,17,17,17,17,17,17,17,17,34
34,17,17,17,108,17,17,17,56,56,17,17,17,17,108,17,17,17,17,17,17,17,34
34,34,17,17,110,17,17,17,17,17,17,17,17,17,110,17,17,17,17,17,17,34,34
34,34,17,17,17,17,17,17,17,17,17,17,38,17,17,17,17,17,17,17,34,34,34
34,34,34,17,17,17,17,17,3,30,17,17,17,17,17,17,17,17,17,34,34,34,34
34,34,34,34,17,17,17,17,32,31,17,17,17,17,17,17,34,34,34,34,34,34,34
34,34,34,34,34,34,34,34,34,34,34,34,34,34,34,34,34,34,34,34,34,34,34
